10108
1011111111
1111111101
1111111111
1111111111
1111111110
1111111110
1101101110
1111110111
0111111111
1101111111
